10
..#......#
#.#.####.#
#.#....#.#
#.####.#.#
#......#.#
#.######.#
#.#....#.#
#.#.##.#.#
#...##...#
######.#S#