50
.#................................................
.#.###############################################
.#................................................
.######.##########################################
.#....#.#.......................................#.
.#.##.#.#.#####################################.#.
.#.#.#.#.#.#.................................#.#.#
.#.#.#.#.#.#.#############################.#.#.#.#
.#.#.#.#.#.#.#...........................#.#.#.#.#
.#.#.#.#.#.#.#.#######################.#.#.#.#.#.#
.#.#.#.#.#.#.#.#.....................#.#.#.#.#.#.#
.#.#.#.#.#.#.#.#.#################.#.#.#.#.#.#.#.#
.#.#.#.#.#.#.#.#.#...............#.#.#.#.#.#.#.#.#
.#.#.#.#.#.#.#.#.#############.#.#.#.#.#.#.#.#.#.#
.#.#.#.#.#.#.#.#.#.............#.#.#.#.#.#.#.#.#.#
.#.#.#.#.#.#.#.#.###############.#.#.#.#.#.#.#.#.#
.#.#.#.#.#.#.#.#.................#.#.#.#.#.#.#.#.#
.#.#.#.#.#.#.#.###################.#.#.#.#.#.#.#.#
.#.#.#.#.#.#.#.........................#.#.#.#.#.#
.#.#.#.#.#.#.#########################.#.#.#.#.#.#
.#.#.#.#.#.#...........................#.#.#.#.#.#
.#.#.#.#.#.#########################.#.#.#.#.#.#.#
.#.#.#.#.#.........................#.#.#.#.#.#.#.#
.#.#.#.#.#######################.#.#.#.#.#.#.#.#.#
.#.#.#.#.....................#.#.#.#.#.#.#.#.#.#.#
.#.#.#.#################.#.#.#.#.#.#.#.#.#.#.#.#.#
.#.#.#.#...............#.#.#.#.#.#.#.#.#.#.#.#.#.#
.#.#.#.#############.#.#.#.#.#.#.#.#.#.#.#.#.#.#.#
.#.#.#.#.............#.#.#.#.#.#.#.#.#.#.#.#.#.#.#
.#.#.#.###############.#.#.#.#.#.#.#.#.#.#.#.#.#.#
.#.#.#.#.................#.#.#.#.#.#.#.#.#.#.#.#.#
.#.#.#.###################.#.#.#.#.#.#.#.#.#.#.#.#
.#.#.#.........................#.#.#.#.#.#.#.#.#.#
.#.#.#########################.#.#.#.#.#.#.#.#.#.#
.#.#...........................#.#.#.#.#.#.#.#.#.#
.#.###########################.#.#.#.#.#.#.#.#.#.#
.#.............................#.#.#.#.#.#.#.#.#.#
.################################.#.#.#.#.#.#.#.#.
................................#.#.#.#.#.#.#.#.#.
##############################.#.#.#.#.#.#.#.#.#.#
#..............................#.#.#.#.#.#.#.#.#.#
#.############################.#.#.#.#.#.#.#.#.#.#
#.#............................#.#.#.#.#.#.#.#.#.#
#.#.##########################.#.#.#.#.#.#.#.#.#.#
#.#.#..........................#.#.#.#.#.#.#.#.#.#
#.#.#.########################.#.#.#.#.#.#.#.#.#.#
#.#.#.#........................#.#.#.#.#.#.#.#.#.#
#.#.#.#.######################.#.#.#.#.#.#.#.#.#.#
#.#.#.#.#......................#.#.#.#.#.#.#.#...#
################################.#.#.#.#.#.#.#####
..................................#.#.#.#.#......S