20
.#..................
.#.#################
.#.................#
.#######.#########.#
.#.....#.#.......#.#
.#.###.#.#.#####.#.#
.#.#.#.#.#.#...#.#.#
.#.#.#.#.#.#.#.#.#.#
.#.#.#.#.#.#.#.#.#.#
...#.#.#.#.#.#.#.#.#
.#.#.#.#.#.#.#.#.#.#
.#.#.#.#.#.#.#.#.#.#
.#.#.#.#.#.#.#.#.#.#
.#.#.#.#.#.#.#.#.#.#
.#.#.#.#.#.#.#.#.#.#
.#.#.#.#.#.#.#.#.#.#
.#.#.#.#.#.#.#.#.#.#
.#.#.#.#.#.#.#.#.#.#
.#...............#.#
##################S#